063 066 066 066 066 066 066 066 066 066 066 066 066 066 066 066 066 064
063 065 065 065 065 065 065 065 065 065 065 065 065 065 065 065 065 064
063 065 065 065 065 065 065 065 065 065 065 065 065 065 065 065 065 064
063 067 062 062 062 062 062 062 062 062 062 062 062 062 062 062 062 064
063 062 062 062 062 062 067 067 067 067 067 067 067 067 067 062 062 064
063 062 062 062 062 062 067 067 067 067 067 067 067 067 067 062 062 064
063 062 062 062 062 062 062 062 062 062 062 062 062 062 062 062 062 064
063 062 062 062 062 062 062 062 062 062 062 062 062 062 062 062 062 064
063 067 067 067 062 062 062 062 062 062 062 062 067 067 067 067 067 064
063 062 062 062 062 062 062 062 062 062 062 062 062 062 062 062 062 064
063 062 062 062 062 062 062 062 062 062 062 062 062 062 062 062 062 064
063 067 067 067 062 062 062 062 062 062 062 062 062 062 062 062 062 064
063 067 067 067 062 062 062 062 062 062 062 062 062 062 062 062 062 064
063 067 067 067 062 062 062 062 062 062 062 062 062 062 062 062 062 064
063 062 062 062 062 062 062 062 062 062 062 062 062 062 062 062 062 064
063 062 062 062 062 062 062 062 062 062 062 062 062 062 062 062 067 064
063 066 066 066 066 066 066 066 066 062 066 066 066 066 066 066 066 064